R 2400 1200
NO ./resources/wall_1.xpm
SO ./resources/wall_2.xpm
WE ./resources/wall_3.xpm
EA ./resources/wall_4.xpm

S ./resources/sprite_3.xpm
C 30,20,10
F 80,60,30

        1111111111111111111111111
        1000022222222222222222221
        1011022222222222222222221
        1011022222222222222222221
        1011022222222222222222221
        1011022222222222222222221
        1011022222222222222222221
        1011022222222222222222221
        1001022222222222222222221
111111111011000001110002000000001
100000000011000001110111111111111
11110111111111011100000010001
11110111111111011101010010001
11000000110101011100000010001
100E0000000000001100000010001
10000000000000001101010010001
110000011101010111110111100111
11110111 1110101 101111010001
11111111 11111111111111111111
